1111111111111111111111111111111111
1E0000P00000000C00000C000000000001
1000010100100000101001000000010101
1000010010101010001001000000010101
100000000C00C000000000000000000001
1111111111111111111111111111111111