1111111
10000E1
1C00001
1P00001
1111111