1111111111111
10000100E0001
1C00010000001
1P00000000001
1001000001111
1001000000001
1111111111111