1111111111111
1000010000001
1C00010000001
1P0000000C0C1
1001E00001111
1001000000001
1111111111111