1111111
1000PE1
1000001
1000001
1111111