1111111
1000PE1
1C0C001
1P00001
1111111