1111111
 1P0E1
  11
  1
  11
 1C1
111111