1111111
1111101
1111C11
1P11C11
1111111