1111111
1000E1
100C1
1P01
111
11
1