1111111
1000DE1
1000C01
1P00C01
1111111