1111111
11111E1
1111C11
1P11C11
1111111