1111110
10000E0
1000C00
1P00C00
1111110